....................
r..W...........X....
...--..W.......--...
....W.--........W..R
...--..........--...
r..W......W....W....
...--....--....--...
....W...........W...
...--........W.--...
r..W........--.W....
...--..........--...
....W...........W..R
...--..........--...
.1..................
######..####..######
Багато, багато, багато рокет!
